Ditjen	NNP
Bea	NNP
dan	CC
Cukai	NNP
Kementerian	NNP
Keuangan	NNP
(	SYM
Kemenkeu	NNP
)	SYM
memastikan	VB
ada	NN
nya	DT
18	NUM
kotak	NN
selundupan	NN
yang	PR
dibawa	VB
melalui	IN
pesawat	NN
baru	JJ
Airbus	NNP
A330-900	NNP
Neo	NNP
milik	VB
Garuda	NNP
Indonesia	NNP
.	SYM